


F 0,200,2000
NO ./tex/NO.xpm
EA ./tex/EA.xpm
SO ./tex/SO.xpm
WE ./tex/WE.xpm
C 50,50,8000

11111
10S01
10001
10001
10001
11001
10001
10001
10001
10001
10001
11111