


F 0,200,200
NO ./tex/NO.xpm
SO ./tex/SO.xpm
WE ./tex/WE.xpm
EA ./tex/EA.xpm
C 50,50,256

11111
10S01
10001
10001
10001
11001
10001
10001
10001
10001
10001
11111
