NO textures/text.png
EA textures/text.png
SO textures/text.png
WE textures/text.png

C 35,21,150
F 15,6,40

111111111111111
111111000111111
111110000011111
1111000N0001111
111000000000111
110000000000011
100001111100001
110000101000011
111000010000111
111100000001111
111110000011111
111111101111111
111111111111111