
NO textures/wall.png
SO textures/wall.png
WE textures/wall.png
EA textures/wall.png
DO textures/wall.png

F 234,221,202
C 0,255,255

111111111111111111111111111111111111
100000000000000000000000000000000001
100000000000000000000000000000000001
100000000000000000000000000000000001
1000000001111111D1111110000000000001
100000000000000000000000000000000001
100000000000000000000000000000000001
100000000000000000000000000000000001
100000000000000N00000000000000000001
100000000000000010000000000000000001
100000000000000001000000000000000001
100000000000000000000000000000000001
100000000000000000000000000000000001
100000000000000000000000000000000001
111111111111111111111111111111111111